33333333333333333333333333333333333333333333333333
30000000000000000000000000000000000000000000000003
30000000000000000000000000000000000000000000000003
30000000000000000000000000000000000000000000000003
30000000000000000000000000000000000000000000000003
30000000000000000000000000000000000000000000000003
30000000000000000000000000000000000000000000000003
30000000000000000000000000000000000000060000000003
30000000006600000000000000000000000000000000000003
30000000000000000000000000000000000000000000000003
30000000000000000000000000000000000000000000000003
30000000000000000000000000000000000000000000000003
30000000000000000000000000000000000000000000000003
30000000000000000000000000000000000000000000000003
300000000066000000000000000000000000000000000000003
30000000000000000000000000000000000000000000000003
30000000000000000000000000330000000000000000000003
30000000000000000000005500000000000000000000000003
30000000000000000000055550000000000000000000000003
30000000000000000000555555000000000000000000000003
30000000000000000000555555000000000000000000000003
30000000000000000000555555000000000000000000000003
30000000000000000000055550000000000000000000000003
30000000000000000000005500000000000000000000000003
30000000000000000004444444400000000000000000000003
30000000000000000003300000000000000000000000000003
30000000000000000000000000000000000000000000000003
30000000000000000000000000000000000000000000000003
30000000000000000000000000000000000000000000000003
30000000000000000000000000000000000000000000000003
30000000000000000000000000000000000000000000000003
30000000000000000000000000000000000000006000000003
30000000000000000000000000000000000000000000000003
30000000000000000000000000000000000000000000000003
30000000000000000000000000000000000000000000000003
30000000000000000000000000000000000000000000000003
30000000000000000000000000000000000000000000000003
30000000000000000000000000000000000000000000000003
30000000000000000000000000000000000000000000000003
30000000000000000000000000000000000000000000000003
30000000000000000000000000000000000000000000000003
30000000000000000000000000000000000000000000000003
30000000000000000000000000000000000000000000000003
30000000000000000000000000000000000000000000000003
30000000000000000000000000000000000000000000000003
30000000000000000000000000000000000000000000000003
30000000000000000000000000000000000000000000000003
30000000000000000000000000000000000000000000000003
30000000000000000000000000000000000000000000000003
33333333333333333333333333333333333333333333333333